################################################################################
#####        ########################################################       ####
#####        ####      ###    #######       #########################       ####
#####        ####      ###    #######       #########################       ####
#####        ####      ###    #######       #######      ############       ####
#####        ####      ###    #######       #######      #######################
#####        ####      ############################      #######################
#####        ####      ############################      ###        ##       ###
#####        ####      ############      ##########      ###        ##       ###
#####        ####      #####     ##      ##########      ###        ##       ###
#####        ####      #####     ##      ##########      ###        ##       ###
#####        ####      #####     ##      ##########      ###        ##       ###
#################      #####     ##      ##########      ###        ############
############################     ##      ##########      ###        ############
#########     ##############     ##      #######################################
#########     #####################      ###############################     ###
#########     #############################################           ##     ###
#########     #############################    ############           ##     ###
##     ##     #########     ###############    ############           ##     ###
##     ##     #########     ##     ########    ####    ####           ##     ###
##     ##     ###    ##     ##     ########    ####    ####           ##########
##     ##     ###    ##     ##     ########    ####    #########################
##     ##     ###    ##     ##     ########    ####    #########################
##     ##     ###    #########     ########    #################################
################################################################################
